NO Textures/quarzo1.png
SO Textures/quarzo2.png
WE Textures/quarzo3.png
EA Textures/quarzo4.png

F 124,124,124
C 255,255,255

111111111
100000001
100000001
100000001
101000001
100100011
10N000001
100000001
100000001
100000001
111111111

